*******
*     *
*     *
*  S **
*     *
*     *
*******