*E*******
*     *  
*  *** * 
* * *  * 
* * *** *
*  *  *  
** S * * 
*     *  
*********