*************************************
*        *            ** *          *
*     *  *      ***          **     *
*  S **  ******** *****   ******    *
*     *         ***   *****    ***  *
*     ****   *  *   *    *   *     **
*******   *****   ****     **  *E****